1111111111111111111111111111111111
1000000000000000000000000000000001
10P0000000000000000000000000000001
1000010000000000000000000000000001
10001C0000000000000000000000000001
1000010000000000000000000000000001
1000000000000000000000000000000001
1000000000000000000000000000000001
100000000C000000000000000000000001
1000000000000000000000000000000001
1000000000000000000000000000000001
1000000000000000000000000000000001
1000000000000000000C00000000000001
1000000000000000000000000000000001
1000000000000000000000000000000001
1000000000000000000000000000000001
1000000C0000000000000000000000E001
1000000000000000000000000000000001
1111111111111111111111111111111111