1111111111111111111111111111111111111
1C00000000000000000000000000000000001
100000000000000000000000000EE00000001
1000000000000000000000000000000000001
100000000E0000000000E00000000E0000001
1000000000000000000000000000000000001
100000000000000000000EE00000000000001
10000000000000000000E000E000000000001
1011000000000000000000000000000000001
1010100000000000000000000000000000001
100000000E0000000000000000E000E000001
10000000001P0000000000000000000000001
1000000000010000000001001100000000001
1000000000000000000000000000000000001
1000000000000000000000000000000000011
1000000000000000000000000000000000001
1111111111111111111111111111111111111