111111111
10P000001
100C00001
10C000E01
111111111