111111111111111111
100000P00000000001
100000000010000001
100000000110001001
100001000000000001
10000100000C000001
100001111000000001
100000000000000001
1000000000000E0001
111111111111111111
