11111111111
100P00P0001
1EE10111001
101101P10P1
11111111111
