111111111111111111
100P00000000000001
100000000000000001
100000000000001001
100000000000000001
100000000000000001
100000000000000001
10000E0000000E0001
100000000000000001
111111111111111111
