1111111111111
1101010101101
10000000000C1
100011E00C0P1
1111111111111
