1111111111111
1101010101101
1000000000001
100P11E00C001
1111111111111
